REGISTRO DE CONTROL DE INVENTARIOS
Empresa,"Paredes & Paredes, S.A. de C.V"
NIT,06143005061013
NRC,1726313
Período,Del 2025-10-01 al 2025-10-25
Artículo,TECLADO-MECA-001 - Teclado Mecánico Inalámbrico RGB

Correlativo,Fecha,Tipo Doc,No. Documento,Proveedor,Nacionalidad,Fuente/Referencia,Unidades Entrada,Unidades Salida,Saldo Unidades,Costo Entrada,Costo Salida,Saldo Costo
454,2025-10-24 23:33:06,01,DTE-01-M305P966-000001759816801,Distribuciones del Pacífico,Nacional,Compra automática de prueba - 2025-10-07,70.00,,70.00,3658.20,,3658.20
455,2025-10-24 23:33:06,03,DTE-03-P731P670-000001760076002,Distribuciones del Pacífico,Nacional,Compra automática de prueba - 2025-10-10,64.00,,134.00,3616.64,,7274.84
456,2025-10-24 23:33:06,03,DTE-03-S957P845-000001759730403,Proveedor Mayorista San Salvador,Nacional,Compra automática de prueba - 2025-10-06,65.00,,199.00,2553.85,,9828.69
457,2025-10-24 23:33:06,01,DTE-01-P589P195-000001759557604,Suministros Industriales SV,Nacional,Compra automática de prueba - 2025-10-04,40.00,,239.00,1608.80,,11437.49
458,2025-10-24 23:33:06,01,DTE-01-B265P942-000001761112805,Global Trade El Salvador S.A.,Nacional,Compra automática de prueba - 2025-10-22,7.00,,246.00,288.33,,11725.82
459,2025-10-24 23:33:06,01,DTE-01-S597P148-000001759816806,Comercial El Salvador Import Export,Nacional,Compra automática de prueba - 2025-10-07,89.00,,335.00,4868.30,,16594.12
