REGISTRO DE CONTROL DE INVENTARIOS
Empresa,"Paredes & Paredes, S.A. de C.V"
NIT,06143005061013
NRC,1726313
Período,Del 2025-10-01 al 2025-10-25
Artículo,MONITOR-DELL-27 - Monitor Dell 27 Pulgadas 4K UHD

Correlativo,Fecha,Tipo Doc,No. Documento,Proveedor,Nacionalidad,Fuente/Referencia,Unidades Entrada,Unidades Salida,Saldo Unidades,Costo Entrada,Costo Salida,Saldo Costo
441,2025-10-24 23:33:06,03,DTE-03-B954P240-000001761372001,Suministros Industriales SV,Nacional,Compra automática de prueba - 2025-10-25,96.00,,96.00,22421.76,,22421.76
442,2025-10-24 23:33:06,03,DTE-03-S157P104-000001761112802,Distribuidora Nacional S.A. de C.V.,Nacional,Compra automática de prueba - 2025-10-22,92.00,,188.00,29453.80,,51875.56
443,2025-10-24 23:33:06,01,DTE-01-B905P571-000001759730403,Importadora Tech Central America,Nacional,Compra automática de prueba - 2025-10-06,60.00,,248.00,21264.00,,73139.56
444,2025-10-24 23:33:06,03,DTE-03-B243P552-000001761199204,Distribuidora Nacional S.A. de C.V.,Nacional,Compra automática de prueba - 2025-10-23,50.00,,298.00,12225.50,,85365.06
445,2025-10-24 23:33:06,01,DTE-01-M541P684-000001759730405,Comercial El Salvador Import Export,Nacional,Compra automática de prueba - 2025-10-06,10.00,,308.00,3196.20,,88561.26
446,2025-10-24 23:33:06,01,DTE-01-S163P173-000001759471206,Comercial El Salvador Import Export,Nacional,Compra automática de prueba - 2025-10-03,93.00,,401.00,22526.46,,111087.72
