REGISTRO DE CONTROL DE INVENTARIOS
Empresa,"Paredes & Paredes, S.A. de C.V"
NIT,06143005061013
NRC,1726313
Período,Del 2025-10-01 al 2025-10-31
Artículo,MONITOR-DELL-27 - Monitor Dell 27 Pulgadas 4K UHD

Correlativo,Fecha,Tipo Doc,No. Documento,Proveedor,Nacionalidad,Fuente/Referencia,Unidades Entrada,Unidades Salida,Saldo Unidades,Costo Entrada,Costo Salida,Saldo Costo
14,2025-10-23 12:01:30,,,,,Compra inicial de monitores,30.00,,30.00,6000.00,,6000.00
15,2025-10-23 12:01:30,,,,,Segunda compra - modelos premium,20.00,,50.00,5000.00,,11000.00
16,2025-10-23 12:01:30,,,,,Tercera compra - liquidación,25.00,,75.00,4500.00,,15500.00
31,2025-10-23 12:29:07,,,,,Compra inicial de monitores,30.00,,105.00,6000.00,,21500.00
32,2025-10-23 12:29:07,,,,,Segunda compra - modelos premium,20.00,,125.00,5000.00,,26500.00
33,2025-10-23 12:29:07,,,,,Tercera compra - liquidación,25.00,,150.00,4500.00,,31000.00
48,2025-10-23 12:31:58,,,,,Compra inicial de monitores,30.00,,180.00,6000.00,,37000.00
49,2025-10-23 12:31:58,,,,,Segunda compra - modelos premium,20.00,,200.00,5000.00,,42000.00
50,2025-10-23 12:31:58,,,,,Tercera compra - liquidación,25.00,,225.00,4500.00,,46500.00
