REGISTRO DE CONTROL DE INVENTARIOS
Empresa,"Paredes & Paredes, S.A. de C.V"
NIT,06143005061013
NRC,1726313
Período,Del 2025-10-01 al 2025-10-31
Artículo,PROD-20251021-0048 - Dell Latitude 5520 Laptop

Correlativo,Fecha,Tipo Doc,No. Documento,Proveedor,Nacionalidad,Fuente/Referencia,Unidades Entrada,Unidades Salida,Saldo Unidades,Costo Entrada,Costo Salida,Saldo Costo
56,2025-10-24 13:27:49,03,DTE-03-00012345,Distribuidora Tech El Salvador S.A. de C.V.,Nacional,Compra de prueba con CCF,50.00,,50.00,21250.00,,21250.00
57,2025-10-24 13:27:49,01,FAC-00056789,Tienda Local de Computadoras,Nacional,Compra menor con factura,25.00,,75.00,10000.00,,31250.00
58,2025-10-24 13:31:45,03,DTE-03-00012345,Distribuidora Tech El Salvador S.A. de C.V.,Nacional,Compra de prueba con CCF,50.00,,125.00,21250.00,,52500.00
59,2025-10-24 13:31:45,01,FAC-00056789,Tienda Local de Computadoras,Nacional,Compra menor con factura,25.00,,150.00,10000.00,,62500.00
60,2025-10-24 13:32:06,03,DTE-03-00012345,Distribuidora Tech El Salvador S.A. de C.V.,Nacional,Compra de prueba con CCF,50.00,,200.00,21250.00,,83750.00
61,2025-10-24 13:32:06,01,FAC-00056789,Tienda Local de Computadoras,Nacional,Compra menor con factura,25.00,,225.00,10000.00,,93750.00
