REGISTRO DE CONTROL DE INVENTARIOS
Empresa,"Paredes & Paredes, S.A. de C.V"
NIT,06143005061013
NRC,1726313
Período,Del 2025-10-01 al 2025-10-27
Artículo,LAPTOP-DELL-001 - Laptop Dell Latitude 5520

Correlativo,Fecha,Tipo Doc,No. Documento,Proveedor,Nacionalidad,Fuente/Referencia,Unidades Entrada,Unidades Salida,Saldo Unidades,Costo Entrada,Costo Salida,Saldo Costo
548,2025-10-26 13:28:18,01,DTE-01-B598P865-000001759557601,Proveedor Mayorista San Salvador,Nacional,Compra automática de prueba - 2025-10-04,60.00,,60.00,54414.60,,54414.60
549,2025-10-26 13:28:18,01,DTE-01-M522P591-000001759644002,Comercial El Salvador Import Export,Nacional,Compra automática de prueba - 2025-10-05,95.00,,155.00,91102.15,,145516.75
550,2025-10-26 13:28:18,01,DTE-01-M165P710-000001759816803,Distribuciones del Pacífico,Nacional,Compra automática de prueba - 2025-10-07,22.00,,177.00,15878.72,,161395.47
551,2025-10-26 13:28:18,03,DTE-03-B900P164-000001760162404,Comercial El Salvador Import Export,Nacional,Compra automática de prueba - 2025-10-11,93.00,,270.00,77748.00,,239143.47
552,2025-10-26 13:28:18,01,DTE-01-P311P642-000001760076005,Proveedor Mayorista San Salvador,Nacional,Compra automática de prueba - 2025-10-10,87.00,,357.00,80615.07,,319758.54
553,2025-10-26 13:28:18,03,DTE-03-B866P821-000001760853606,Distribuidora Nacional S.A. de C.V.,Nacional,Compra automática de prueba - 2025-10-19,13.00,,370.00,10834.46,,330593.00
